6 6 300.00 0
RRRRP RRRR_ RRRR_ RRRR_ RRRR_ RRGG_
GGBB_ GGGG_ GGGG_ GGGG_ GGGG_ GGGG_
BBBB_ BBBB_ BBBB_ BBBB_ BBBB_ BBYY_
YYYY_ YYYY_ GGGG_ GGGGG YYYY_ YYYY_
YYCC_ CCCC_ CCCC_ CCCC_ CCCC_ CCCC_
MMMMD MMMM_ MMMM_ MMMM_ MMMM_ CCMM_
