10 5 300.00 0
RRRR BBBB RRRR RRRR RRRR BBBB BBBB BBBB BBBB BBBB
RRRR BBBB RRRR BBBB RRRR BBBB BBBB BBBB BBBB BBBB
RRRR BBBB RRRR RRRR RRRR BBBB BBBB BBBB BBBB BBBB
RRRR BBBB BBBB BBBB BBBB BBBB BBBB BBBB BBBB BBRR
RRRR RRRR RRRR RRRR RRRR RRRR RRRR RRRR RRRR RRRR
CP00 LD31