35 17 300.00 0
YYYY_ YYYY_ YYYY_ YYYY_ YYYY_ YYYY_ YYYY_ YYYY_ YYYY_ YYYY_ YYYY_ YYYY_ YYYY_ YYYY_ YYYY_ YYYY_ YYYY_ YYYY_ YYYY_ YYYY_ YYYY_ YYYY_ YYYY_ YYYY_ YYYY_ YYYY_ YYYY_ YYYY_ YYYY_ YYYY_ YYYY_ YYYY_ YYYY_ YYYY_ YYYY_
YYYY_ YYYY_ YYYY_ YYYY_ YYYY_ YYYY_ YYYY_ YYYY_ YYYY_ YYYY_ YYYY_ YYYY_ YYYY_ YYYY_ YYYY_ YYYY_ YYYY_ YYYY_ YYYY_ YYYY_ YYYY_ YYYY_ YYYY_ YYYY_ YYYY_ YYYY_ YYYY_ YYYY_ YYYY_ YYYY_ YYYY_ YYYY_ YYYY_ YYYY_ YYYY_
YYYY_ YYYY_ YYYY_ YYYY_ YYYY_ YYYY_ YYYY_ YYYY_ YYYY_ YYYY_ YYYY_ YYYY_ YYYY_ YYYY_ YYYY_ YYYY_ YYYY_ YYYY_ YYYY_ YYYY_ YYYY_ YYYY_ YYYY_ YYYY_ YYYY_ YYYY_ YYYY_ YYYY_ YYYY_ YYYY_ YYYY_ YYYY_ YYYY_ YYYY_ YYYY_
YYYY_ YYYY_ YYYY_ YYYY_ YYYY_ YYYY_ YYYY_ YYYY_ YYYY_ YYYY_ YYYY_ YYYY_ YYYY_ YYYY_ YYYY_ YYYY_ YYYY_ YYYY_ YYYY_ YYYY_ YYYY_ YYYY_ YYYY_ YYYY_ YYYY_ YYYY_ YYYY_ YYYY_ YYYY_ YYYY_ YYYY_ YYYY_ YYYY_ YYYY_ YYYY_
YYYY_ YYYY_ YYYY_ YYYY_ YYYY_ YYYY_ YYYY_ YYYY_ YYYY_ YYYY_ YYYY_ YYYY_ YYYY_ YYYY_ YYYY_ YYYY_ YYYY_ YYYY_ YYYY_ YYYY_ YYYY_ YYYY_ YYYY_ YYYY_ YYYY_ YYYY_ YYYY_ YYYY_ YYYY_ YYYY_ YYYY_ YYYY_ YYYY_ YYYY_ YYYY_
YYYY_ YYYY_ YYYY_ YYYY_ YYYY_ YYYY_ YYYY_ YYYY_ YYYY_ YYYY_ YYYY_ YYYY_ YYYY_ YYYY_ YYYY_ YYYY_ YYYY_ YYYY_ YYYY_ YYYY_ YYYY_ YYYY_ YYYY_ YYYY_ YYYY_ YYYY_ YYYY_ YYYY_ YYYY_ YYYY_ YYYY_ YYYY_ YYYY_ YYYY_ YYYY_
YYYY_ YYYY_ YYYY_ YYYY_ YYYY_ YYYY_ YYYY_ YYYY_ YYYY_ YYYY_ YYYY_ YYYY_ BBBBY BBBB_ BBBB_ BBBB_ BBBB_ BBBB_ BBBB+ YYYY_ YYYY_ YYYY_ YYYY_ YYYY_ YYYY_ YYYY_ YYYY_ YYYY_ YYYY_ YYYY_ YYYY_ YYYY_ YYYY_ YYYY_ YYYY_
YYYY_ YYYY_ YYYY_ YYYY_ YYYY_ YYYY_ YYYY_ YYYY_ YYYY_ YYYY_ YYYY_ YYYY_ BBBB_ YYYY_ YYYY_ YYYY_ YYYY_ YYYY_ BBBB_ YYYY_ YYYY_ YYYY_ YYYY_ YYYY_ YYYY_ YYYY_ YYYY_ YYYY_ YYYY_ YYYY_ YYYY_ YYYY_ YYYY_ YYYY_ YYYY_
YYYY_ YYYY_ YYYY_ YYYY_ YYYY_ YYYY_ YYYY_ YYYY_ YYYY_ YYYY_ YYYY_ YYYY_ BBBB_ YYYY_ YYYY_ YYYY_ YYYY_ YYYY_ BBBB_ YYYY_ YYYY_ YYYY_ YYYY_ YYYY_ YYYY_ YYYY_ YYYY_ YYYY_ YYYY_ YYYY_ YYYY_ YYYY_ YYYY_ YYYY_ YYYY_
YYYY_ YYYY_ YYYY_ BBBBP YYYY_ YYYY_ YYYY_ YYYY_ YYYY_ YYYY_ YYYY_ YYYY_ BBBBN YYYY_ YYYY_ BBBBD YYYY_ YYYY_ BBBBG YYYY_ YYYY_ YYYY_ YYYY_ YYYY_ YYYY_ YYYY_ YYYY_ YYYY_ YYYY_ YYYY_ YYYY_ YYYY_ YYYY_ YYYY_ YYYY_
YYYY_ YYYY_ YYYY_ YYYY_ YYYY_ YYYY_ YYYY_ YYYY_ YYYY_ YYYY_ YYYY_ YYYY_ BBBB_ YYYY_ YYYY_ YYYY_ YYYY_ YYYY_ BBBB_ YYYY_ YYYY_ YYYY_ YYYY_ YYYY_ YYYY_ YYYY_ YYYY_ YYYY_ YYYY_ YYYY_ YYYY_ YYYY_ YYYY_ YYYY_ YYYY_
YYYY_ YYYY_ YYYY_ YYYY_ YYYY_ YYYY_ YYYY_ YYYY_ YYYY_ YYYY_ YYYY_ YYYY_ BBBB_ YYYY_ YYYY_ YYYY_ YYYY_ YYYY_ BBBB_ YYYY_ YYYY_ YYYY_ YYYY_ YYYY_ YYYY_ YYYY_ YYYY_ YYYY_ YYYY_ YYYY_ YYYY_ YYYY_ YYYY_ YYYY_ YYYY_
YYYY_ YYYY_ YYYY_ YYYY_ YYYY_ YYYY_ YYYY_ YYYY_ YYYY_ YYYY_ YYYY_ YYYY_ BBBB+ BBBB_ BBBB_ BBBB_ BBBB_ BBBB_ BBBBY YYYY_ YYYY_ YYYY_ YYYY_ YYYY_ YYYY_ YYYY_ YYYY_ YYYY_ YYYY_ YYYY_ YYYY_ YYYY_ YYYY_ YYYY_ YYYY_
YYYY_ YYYY_ YYYY_ YYYY_ YYYY_ YYYY_ YYYY_ YYYY_ YYYY_ YYYY_ YYYY_ YYYY_ YYYY_ YYYY_ YYYY_ YYYY_ YYYY_ YYYY_ YYYY_ YYYY_ YYYY_ YYYY_ YYYY_ YYYY_ YYYY_ YYYY_ YYYY_ YYYY_ YYYY_ YYYY_ YYYY_ YYYY_ YYYY_ YYYY_ YYYY_
YYYY_ YYYY_ YYYY_ YYYY_ YYYY_ YYYY_ YYYY_ YYYY_ YYYY_ YYYY_ YYYY_ YYYY_ YYYY_ YYYY_ YYYY_ YYYY_ YYYY_ YYYY_ YYYY_ YYYY_ YYYY_ YYYY_ YYYY_ YYYY_ YYYY_ YYYY_ YYYY_ YYYY_ YYYY_ YYYY_ YYYY_ YYYY_ YYYY_ YYYY_ YYYY_
YYYY_ YYYY_ YYYY_ YYYY_ YYYY_ YYYY_ YYYY_ YYYY_ YYYY_ YYYY_ YYYY_ YYYY_ YYYY_ YYYY_ YYYY_ YYYY_ YYYY_ YYYY_ YYYY_ YYYY_ YYYY_ YYYY_ YYYY_ YYYY_ YYYY_ YYYY_ YYYY_ YYYY_ YYYY_ YYYY_ YYYY_ YYYY_ YYYY_ YYYY_ YYYY_
YYYY_ YYYY_ YYYY_ YYYY_ YYYY_ YYYY_ YYYY_ YYYY_ YYYY_ YYYY_ YYYY_ YYYY_ YYYY_ YYYY_ YYYY_ YYYY_ YYYY_ YYYY_ YYYY_ YYYY_ YYYY_ YYYY_ YYYY_ YYYY_ YYYY_ YYYY_ YYYY_ YYYY_ YYYY_ YYYY_ YYYY_ YYYY_ YYYY_ YYYY_ YYYY_
How To Play!