6 6 300.00 0
RRRRP RRRR_ RRRR_ RRRR_ RRRR_ RRRR_
RRRR_ RRRR_ RRRR_ RRRR_ RRRR_ RRRR_
RRRR_ RRRR_ RRRR> RRRR_ RRRR_ RRRR_
RRRR_ RRRR_ RRRR_ RRRR_ RRRR_ RRRR_
RRRR_ RRRR_ RRRR_ RRRR_ RRRR_ RRRR_
RRRR_ RRRR_ RRRR_ RRRR_ RRRR_ RRRRD
