50 25 300.00 0
RRRRP BBBB_ RRRR_ RRRR_ RRRR_ BBBBF BBBB( BBBB_ BBBB_ BBBB} RRRR_ BBBB_ RRRR_ RRRR_ RRRR_ BBBBF BBBB( BBBB_ BBBB_ BBBB} RRRR_ BBBB_ RRRR_ RRRR_ RRRR_ BBBBF BBBB( BBBB_ BBBB_ BBBB} RRRR_ BBBB_ RRRR_ RRRR_ RRRR_ BBBBF BBBB( BBBB_ BBBB_ BBBB} RRRR_ BBBB_ RRRR_ RRRR_ RRRR_ BBBBF BBBB( BBBB_ BBBB_ BBBB}
RRRR_ BBBB_ RRRR_ BBBBD RRRR_ BBBB_ BBBB( BBBB_ BBBB_ BBBB_ RRRR_ BBBB_ RRRR_ BBBBD RRRR_ BBBB_ BBBB( BBBB_ BBBB_ BBBB_ RRRR_ BBBB_ RRRR_ BBBBD RRRR_ BBBB_ BBBB( BBBB_ BBBB_ BBBB_ RRRR_ BBBB_ RRRR_ BBBBD RRRR_ BBBB_ BBBB( BBBB_ BBBB_ BBBB_ RRRR_ BBBB_ RRRR_ BBBBD RRRR_ BBBB_ BBBB( BBBB_ BBBB_ BBBB_
RRRR_ BBBB_ RRRR_ RRRR_ RRRR_ BBBB{ BBBB( BBBB@ BBBB_ BBBB_ RRRR_ BBBB_ RRRR_ RRRR_ RRRR_ BBBB{ BBBB( BBBB@ BBBB_ BBBB_ RRRR_ BBBB_ RRRR_ RRRR_ RRRR_ BBBB{ BBBB( BBBB@ BBBB_ BBBB_ RRRR_ BBBB_ RRRR_ RRRR_ RRRR_ BBBB{ BBBB( BBBB@ BBBB_ BBBB_ RRRR_ BBBB_ RRRR_ RRRR_ RRRR_ BBBB{ BBBB( BBBB@ BBBB_ BBBB_
RRRR+ BBBB_ BBBB_ BBBB_ BBBB) BBBB_ BBBB( BBBB* BBBB_ BBRR_ RRRR+ BBBB_ BBBB_ BBBB_ BBBB) BBBB_ BBBB( BBBB_ BBBB_ BBRR_ RRRR+ BBBB_ BBBB_ BBBB_ BBBB) BBBB_ BBBB( BBBB_ BBBB_ BBRR_ RRRR+ BBBB_ BBBB_ BBBB_ BBBB) BBBB_ BBBB( BBBB_ BBBB_ BBRR_ RRRR+ BBBB_ BBBB_ BBBB_ BBBB) BBBB_ BBBB( BBBB_ BBBB_ BBRR_
RRRR_ RRRR_ RRRR_ RRRRG RRRR_ RRRR_ RRRR_ RRRR_ RRRR_ RRRR_ RRRR_ RRRR_ RRRR_ RRRRG RRRR_ RRRR_ RRRR_ RRRR_ RRRR_ RRRR_ RRRR_ RRRR_ RRRR_ RRRRG RRRR_ RRRR_ RRRR_ RRRR_ RRRR_ RRRR_ RRRR_ RRRR_ RRRR_ RRRRG RRRR_ RRRR_ RRRR_ RRRR_ RRRR_ RRRR_ RRRR_ RRRR_ RRRR_ RRRRG RRRR_ RRRR_ RRRR_ RRRR_ RRRR_ RRRR_
RRRR_ BBBB_ RRRR_ RRRR_ RRRR_ BBBBF BBBB( BBBB_ BBBB_ BBBB} RRRR_ BBBB_ RRRR_ RRRR_ RRRR_ BBBBF BBBB( BBBB_ BBBB_ BBBB} RRRR_ BBBB_ RRRR_ RRRR_ RRRR_ BBBBF BBBB( BBBB_ BBBB_ BBBB} RRRR_ BBBB_ RRRR_ RRRR_ RRRR_ BBBBF BBBB( BBBB_ BBBB_ BBBB} RRRR_ BBBB_ RRRR_ RRRR_ RRRR_ BBBBF BBBB( BBBB_ BBBB_ BBBB}
RRRR_ BBBB_ RRRR_ BBBBD RRRR_ BBBB_ BBBB( BBBB_ BBBB_ BBBB_ RRRR_ BBBB_ RRRR_ BBBBD RRRR_ BBBB_ BBBB( BBBB_ BBBB_ BBBB_ RRRR_ BBBB_ RRRR_ BBBBD RRRR_ BBBB_ BBBB( BBBB_ BBBB_ BBBB_ RRRR_ BBBB_ RRRR_ BBBBD RRRR_ BBBB_ BBBB( BBBB_ BBBB_ BBBB_ RRRR_ BBBB_ RRRR_ BBBBD RRRR_ BBBB_ BBBB( BBBB_ BBBB_ BBBB_
RRRR_ BBBB_ RRRR_ RRRR_ RRRR_ BBBB{ BBBB( BBBB@ BBBB_ BBBB_ RRRR_ BBBB_ RRRR_ RRRR_ RRRR_ BBBB{ BBBB( BBBB@ BBBB_ BBBB_ RRRR_ BBBB_ RRRR_ RRRR_ RRRR_ BBBB{ BBBB( BBBB@ BBBB_ BBBB_ RRRR_ BBBB_ RRRR_ RRRR_ RRRR_ BBBB{ BBBB( BBBB@ BBBB_ BBBB_ RRRR_ BBBB_ RRRR_ RRRR_ RRRR_ BBBB{ BBBB( BBBB@ BBBB_ BBBB_
RRRR+ BBBB_ BBBB_ BBBB_ BBBB) BBBB_ BBBB( BBBB_ BBBB_ BBRR_ RRRR+ BBBB_ BBBB_ BBBB_ BBBB) BBBB_ BBBB( BBBB_ BBBB_ BBRR_ RRRR+ BBBB_ BBBB_ BBBB_ BBBB) BBBB_ BBBB( BBBB_ BBBB_ BBRR_ RRRR+ BBBB_ BBBB_ BBBB_ BBBB) BBBB_ BBBB( BBBB_ BBBB_ BBRR_ RRRR+ BBBB_ BBBB_ BBBB_ BBBB) BBBB_ BBBB( BBBB_ BBBB_ BBRR_
RRRR_ RRRR_ RRRR_ RRRRG RRRR_ RRRR_ RRRR_ RRRR_ RRRR_ RRRR_ RRRR_ RRRR_ RRRR_ RRRRG RRRR_ RRRR_ RRRR_ RRRR_ RRRR_ RRRR_ RRRR_ RRRR_ RRRR_ RRRRG RRRR_ RRRR_ RRRR_ RRRR_ RRRR_ RRRR_ RRRR_ RRRR_ RRRR_ RRRRG RRRR_ RRRR_ RRRR_ RRRR_ RRRR_ RRRR_ RRRR_ RRRR_ RRRR_ RRRRG RRRR_ RRRR_ RRRR_ RRRR_ RRRR_ RRRR_
RRRR_ BBBB_ RRRR_ RRRR_ RRRR_ BBBBF BBBB( BBBB_ BBBB_ BBBB} RRRR_ BBBB_ RRRR_ RRRR_ RRRR_ BBBBF BBBB( BBBB_ BBBB_ BBBB} RRRR_ BBBB_ RRRR_ RRRR_ RRRR_ BBBBF BBBB( BBBB_ BBBB_ BBBB} RRRR_ BBBB_ RRRR_ RRRR_ RRRR_ BBBBF BBBB( BBBB_ BBBB_ BBBB} RRRR_ BBBB_ RRRR_ RRRR_ RRRR_ BBBBF BBBB( BBBB_ BBBB_ BBBB}
RRRR_ BBBB_ RRRR_ BBBBD RRRR_ BBBB_ BBBB( BBBB_ BBBB_ BBBB_ RRRR_ BBBB_ RRRR_ BBBBD RRRR_ BBBB_ BBBB( BBBB_ BBBB_ BBBB_ RRRR_ BBBB_ RRRR_ BBBBD RRRR_ BBBB_ BBBB( BBBB_ BBBB_ BBBB_ RRRR_ BBBB_ RRRR_ BBBBD RRRR_ BBBB_ BBBB( BBBB_ BBBB_ BBBB_ RRRR_ BBBB_ RRRR_ BBBBD RRRR_ BBBB_ BBBB( BBBB_ BBBB_ BBBB_
RRRR_ BBBB_ RRRR_ RRRR_ RRRR_ BBBB{ BBBB( BBBB@ BBBB_ BBBB_ RRRR_ BBBB_ RRRR_ RRRR_ RRRR_ BBBB{ BBBB( BBBB@ BBBB_ BBBB_ RRRR_ BBBB_ RRRR_ RRRR_ RRRR_ BBBB{ BBBB( BBBB@ BBBB_ BBBB_ RRRR_ BBBB_ RRRR_ RRRR_ RRRR_ BBBB{ BBBB( BBBB@ BBBB_ BBBB_ RRRR_ BBBB_ RRRR_ RRRR_ RRRR_ BBBB{ BBBB( BBBB@ BBBB_ BBBB_
RRRR+ BBBB_ BBBB_ BBBB_ BBBB) BBBB_ BBBB( BBBB_ BBBB_ BBRR_ RRRR+ BBBB_ BBBB_ BBBB_ BBBB) BBBB_ BBBB( BBBB_ BBBB_ BBRR_ RRRR+ BBBB_ BBBB_ BBBB_ BBBB) BBBB_ BBBB( BBBB_ BBBB_ BBRR_ RRRR+ BBBB_ BBBB_ BBBB_ BBBB) BBBB_ BBBB( BBBB_ BBBB_ BBRR_ RRRR+ BBBB_ BBBB_ BBBB_ BBBB) BBBB_ BBBB( BBBB_ BBBB_ BBRR_
RRRR_ RRRR_ RRRR_ RRRRG RRRR_ RRRR_ RRRR_ RRRR_ RRRR_ RRRR_ RRRR_ RRRR_ RRRR_ RRRRG RRRR_ RRRR_ RRRR_ RRRR_ RRRR_ RRRR_ RRRR_ RRRR_ RRRR_ RRRRG RRRR_ RRRR_ RRRR_ RRRR_ RRRR_ RRRR_ RRRR_ RRRR_ RRRR_ RRRRG RRRR_ RRRR_ RRRR_ RRRR_ RRRR_ RRRR_ RRRR_ RRRR_ RRRR_ RRRRG RRRR_ RRRR_ RRRR_ RRRR_ RRRR_ RRRR_
RRRR_ BBBB_ RRRR_ RRRR_ RRRR_ BBBBF BBBB( BBBB_ BBBB_ BBBB} RRRR_ BBBB_ RRRR_ RRRR_ RRRR_ BBBBF BBBB( BBBB_ BBBB_ BBBB} RRRR_ BBBB_ RRRR_ RRRR_ RRRR_ BBBBF BBBB( BBBB_ BBBB_ BBBB} RRRR_ BBBB_ RRRR_ RRRR_ RRRR_ BBBBF BBBB( BBBB_ BBBB_ BBBB} RRRR_ BBBB_ RRRR_ RRRR_ RRRR_ BBBBF BBBB( BBBB_ BBBB_ BBBB}
RRRR_ BBBB_ RRRR_ BBBBD RRRR_ BBBB_ BBBB( BBBB_ BBBB_ BBBB_ RRRR_ BBBB_ RRRR_ BBBBD RRRR_ BBBB_ BBBB( BBBB_ BBBB_ BBBB_ RRRR_ BBBB_ RRRR_ BBBBD RRRR_ BBBB_ BBBB( BBBB_ BBBB_ BBBB_ RRRR_ BBBB_ RRRR_ BBBBD RRRR_ BBBB_ BBBB( BBBB_ BBBB_ BBBB_ RRRR_ BBBB_ RRRR_ BBBBD RRRR_ BBBB_ BBBB( BBBB_ BBBB_ BBBB_
RRRR_ BBBB_ RRRR_ RRRR_ RRRR_ BBBB{ BBBB( BBBB@ BBBB_ BBBB_ RRRR_ BBBB_ RRRR_ RRRR_ RRRR_ BBBB{ BBBB( BBBB@ BBBB_ BBBB_ RRRR_ BBBB_ RRRR_ RRRR_ RRRR_ BBBB{ BBBB( BBBB@ BBBB_ BBBB_ RRRR_ BBBB_ RRRR_ RRRR_ RRRR_ BBBB{ BBBB( BBBB@ BBBB_ BBBB_ RRRR_ BBBB_ RRRR_ RRRR_ RRRR_ BBBB{ BBBB( BBBB@ BBBB_ BBBB_
RRRR+ BBBB_ BBBB_ BBBB_ BBBB) BBBB_ BBBB( BBBB_ BBBB_ BBRR_ RRRR+ BBBB_ BBBB_ BBBB_ BBBB) BBBB_ BBBB( BBBB_ BBBB_ BBRR_ RRRR+ BBBB_ BBBB_ BBBB_ BBBB) BBBB_ BBBB( BBBB_ BBBB_ BBRR_ RRRR+ BBBB_ BBBB_ BBBB_ BBBB) BBBB_ BBBB( BBBB_ BBBB_ BBRR_ RRRR+ BBBB_ BBBB_ BBBB_ BBBB) BBBB_ BBBB( BBBB_ BBBB_ BBRR_
RRRR_ RRRR_ RRRR_ RRRRG RRRR_ RRRR_ RRRR_ RRRR_ RRRR_ RRRR_ RRRR_ RRRR_ RRRR_ RRRRG RRRR_ RRRR_ RRRR_ RRRR_ RRRR_ RRRR_ RRRR_ RRRR_ RRRR_ RRRRG RRRR_ RRRR_ RRRR_ RRRR_ RRRR_ RRRR_ RRRR_ RRRR_ RRRR_ RRRRG RRRR_ RRRR_ RRRR_ RRRR_ RRRR_ RRRR_ RRRR_ RRRR_ RRRR_ RRRRG RRRR_ RRRR_ RRRR_ RRRR_ RRRR_ RRRR_
RRRR_ BBBB_ RRRR_ RRRR_ RRRR_ BBBBF BBBB( BBBB_ BBBB_ BBBB} RRRR_ BBBB_ RRRR_ RRRR_ RRRR_ BBBBF BBBB( BBBB_ BBBB_ BBBB} RRRR_ BBBB_ RRRR_ RRRR_ RRRR_ BBBBF BBBB( BBBB_ BBBB_ BBBB} RRRR_ BBBB_ RRRR_ RRRR_ RRRR_ BBBBF BBBB( BBBB_ BBBB_ BBBB} RRRR_ BBBB_ RRRR_ RRRR_ RRRR_ BBBBF BBBB( BBBB_ BBBB_ BBBB}
RRRR_ BBBB_ RRRR_ BBBBD RRRR_ BBBB_ BBBB( BBBB_ BBBB_ BBBB_ RRRR_ BBBB_ RRRR_ BBBBD RRRR_ BBBB_ BBBB( BBBB_ BBBB_ BBBB_ RRRR_ BBBB_ RRRR_ BBBBD RRRR_ BBBB_ BBBB( BBBB_ BBBB_ BBBB_ RRRR_ BBBB_ RRRR_ BBBBD RRRR_ BBBB_ BBBB( BBBB_ BBBB_ BBBB_ RRRR_ BBBB_ RRRR_ BBBBD RRRR_ BBBB_ BBBB( BBBB_ BBBB_ BBBB_
RRRR_ BBBB_ RRRR_ RRRR_ RRRR_ BBBB{ BBBB( BBBB@ BBBB_ BBBB_ RRRR_ BBBB_ RRRR_ RRRR_ RRRR_ BBBB{ BBBB( BBBB@ BBBB_ BBBB_ RRRR_ BBBB_ RRRR_ RRRR_ RRRR_ BBBB{ BBBB( BBBB@ BBBB_ BBBB_ RRRR_ BBBB_ RRRR_ RRRR_ RRRR_ BBBB{ BBBB( BBBB@ BBBB_ BBBB_ RRRR_ BBBB_ RRRR_ RRRR_ RRRR_ BBBB{ BBBB( BBBB@ BBBB_ BBBB_
RRRR+ BBBB_ BBBB_ BBBB_ BBBB) BBBB_ BBBB( BBBB_ BBBB_ BBRR_ RRRR+ BBBB_ BBBB_ BBBB_ BBBB) BBBB_ BBBB( BBBB_ BBBB_ BBRR_ RRRR+ BBBB_ BBBB_ BBBB_ BBBB) BBBB_ BBBB( BBBB_ BBBB_ BBRR_ RRRR+ BBBB_ BBBB_ BBBB_ BBBB) BBBB_ BBBB( BBBB_ BBBB_ BBRR_ RRRR+ BBBB_ BBBB_ BBBB_ BBBB) BBBB_ BBBB( BBBB_ BBBB_ BBRR_
RRRR_ RRRR_ RRRR_ RRRRG RRRR_ RRRR_ RRRR_ RRRR_ RRRR_ RRRR_ RRRR_ RRRR_ RRRR_ RRRRG RRRR_ RRRR_ RRRR_ RRRR_ RRRR_ RRRR_ RRRR_ RRRR_ RRRR_ RRRRG RRRR_ RRRR_ RRRR_ RRRR_ RRRR_ RRRR_ RRRR_ RRRR_ RRRR_ RRRRG RRRR_ RRRR_ RRRR_ RRRR_ RRRR_ RRRR_ RRRR_ RRRR_ RRRR_ RRRRG RRRR_ RRRR_ RRRR_ RRRR_ RRRR_ RRRR_
