10 5 300.00 0
BBBBD GGGG_ GGGB_ GGBB_ GGBG_ GGGG_ YYYY_ YGYG_ GGGG_ GGGG_
BBBB_ GGGG_ GBGB_ BBBBP BGBG_ GGGG_ YYYY_ GGGG_ GGGG_ YYYY_
BBBB_ GGGG_ GBGG_ BBGG_ BGGG_ GGGG_ YYGG_ GGGG_ GGGG_ GGGG@
BBBB_ GGGGF GGGG_ GGGG_ GGGG_ GGGG_ GGGG_ GGGG_ GGGG_ GGGG_
BYBY_ YYYY_ YYYY_ YYYY_ YYYY_ YYYY_ YYYY_ GGGG_ GGGG_ YYYY_