10 5 300.00 0
BBBB GGGG GGGB GGBB GGBG GGGG YYYY YGYG GGGG GGGG
BBBB GGGG GBGB BBBB BGBG GGGG YYYY GGGG GGGG YYYY
BBBB GGGG GBGG BBGG BGGG GGGG YYGG GGGG GGGG GGGG
BBBB GGGG GGGG GGGG GGGG GGGG GGGG GGGG GGGG GGGG
BYBY YYYY YYYY YYYY YYYY YYYY YYYY GGGG GGGG YYYY
LD00 CP31 L@92 CF13 L*50 L@30 L@54 L*52