35 17 300.00 0
BBBB} BBBB_ BBBB_ BBBB_ BBBB_ BBBB( BBBB_ BBBB_ BBBB_ BBBB_ BBBB_ BBBB_ BBBB_ BBBB_ BBBB_ BBBB_ BBBB_ BBBB_ BBBB_ BBBB_ BBBB_ BBBB_ BBBB_ BBBB_ BBBB_ BBBB_ BCBC_ CCCC_ CCCC_ CCCC_ CCCC_ CCCC_ CCCC_ CCCC_ CCCC_
BBBB_ BBBBT BBBB_ BBBB+ BBBB_ BBBB( BBBB_ BBBB_ BBBB_ BBBB_ BBBB_ BBBB_ BBBB_ BBBB_ BBBB_ BBBB_ BBBB_ BBBB_ BBBB_ BBBB_ BBBB_ BBBB_ BBBB_ BBBB_ BBBB_ BBBB_ BCBC_ CCCC_ CCCC_ CCCC_ CCCC_ CCCC_ CCCC_ CCCC_ CCCC_
BBBB_ BBBB_ BBBBG BBBB_ BBBB_ BBBB( BBBB_ BBBB_ BBBB_ BBBB_ BBBB_ BBBB_ BBBB_ BBBB_ BBBB_ BBBB_ BBBB_ BBBB_ BBBB_ BBBB_ BBBB_ BBBB_ BBBB_ BBBB_ BBBB_ BBBB_ BCBC_ CCCC_ CCCC_ CCCC_ CCCC_ CCCC{ CCCC_ CCCC_ CCCC_
BBBB_ BBBBY BBBB_ BBBB+ BBBB_ BBBB( BBBB_ BBBB_ BBBB_ BBBB_ BBBB_ BBBB_ BBBB_ BBBB_ BBBB_ BBBB_ BBBB_ BBBB_ BBBB_ BBBB_ BBBB_ BBBB_ BBBB_ BBBB_ BBBB_ BBBB_ BCBC_ CCCC_ CCCC_ CCCC_ CCCC_ CCCC_ CCCC_ CCCC_ CCCC_
BBBB_ BBBB_ BBBB_ BBBB_ BBBB_ BBBB( BBBB_ BBBB_ BBBB_ BBBB_ BBBB_ BBBB_ BBBB_ BBBB_ BBBB_ BBBB_ BBBB_ BBBB_ BBBB_ BBBB_ BBBB_ BBBB_ BBBB_ BBBB_ BBBB_ BBBB_ BCBB_ CCBB_ CCBB_ CCBB_ CCBB_ CCBB_ CCBB_ CCBB_ CCBB_
BBBB( BBBB( BBBB( BBBB( BBBB( BBBB( BBBB_ BBBB_ BBBB_ BBBB_ BBBB_ BBBB_ BBBB_ BBBB_ BBBB_ BBBB_ BBBB_ BBBB_ BBBB_ BBBB_ BBBB_ BBBB_ BBBB_ BBBB_ BBBB_ BBBB_ BBBB_ BBBB_ BBBB_ BBBB_ BBBB_ BBBB_ BBBB_ BBBB_ BBBB_
BBBB_ BBBB_ BBBB_ BBBB_ BBBB_ BBBB_ BBBB_ BBBB_ BBBB_ BBBB_ BBBB_ BBBB_ BBBB_ BBBB_ BBBB_ BBBB_ BBBB_ BBBB_ BBBB_ BBBB_ BBBB_ BBBB_ BBBB_ BBBB_ BBBB_ BBBB_ BBBB_ BBBB_ BBBB_ BBBB_ BBBB_ BBBB_ BBBB_ BBBB_ BBBB_
BBBB_ BBBB_ BBBB_ BBBB_ BBBB_ BBBB_ BBBB_ BBBB_ BBBB_ BBBB_ BBBB_ BBBB_ BBBB_ BBBB_ BBBB_ BBBB_ BBBB_ BBBB_ BBBB_ BBBB_ BBBB_ BBBB_ BBBB_ BBBB_ BBBB_ BBBB_ BBBB_ BBBB_ BBBB_ BBBB_ BBBB_ BBBB_ BBBB_ BBBB_ BBBB_
BBBB_ BBBB_ BBBB_ BBBB_ BBBB_ BBBB_ BBBB_ BBBB_ BBBB_ BBBB_ BBBB_ BBBB_ BBBB_ BBBB_ BBBBP BBBBN BBBB_ BBBB_ BBBB_ BBBB_ BBBB_ BBBB_ BBBB_ BBBB_ BBBB_ BBBB_ BBBB_ BBBB_ BBBB_ BBBB_ BBBB_ BBBB_ BBBB_ BBBB_ BBBB_
BBBB_ BBBB_ BBBB_ BBBB_ BBBB_ BBBB_ BBBB_ BBBB_ BBBB_ BBBB_ BBBB_ BBBB_ BBBB_ BBBB_ BBBB_ BBBB_ BBBB_ BBBB_ BBBB_ BBBB_ BBBB_ BBBB_ BBBB_ BBBB_ BBBB_ BBBB_ BBBB_ BBBB_ BBYY) BBYY) BBYY) BBYY) BBYY) BBYY) BBYY)
BBBB_ BBBB_ BBBB_ BBBB_ BBBB_ BBBB_ BBBB_ BBBB_ BBBB_ BBBB_ BBBB_ BBBB_ BBBB_ BBBB_ BBBB_ BBBB_ BBBB_ BBBB_ BBBB_ BBBB_ BBBB_ BBBB_ BBBB_ BBBB_ BBBB_ BBBB_ BBBB_ BBBB_ YYYY_ YYYY_ YYYY_ YYYY_ YYYY_ YYYY_ YYYY_
BBBB_ BBBB_ BBBB_ BBBB_ BBBB_ BBBB_ BBBB_ BBBB_ BBBB_ BBBB_ BBBB_ BBBB_ BBBB_ BBBB_ BBBB_ BBBB_ BBBB_ BBBB_ BBBB_ BBBB_ BBBB_ BBBB_ BBBB_ BBBB_ BBBB_ BBBB_ BBBB_ BBBB_ YYYY_ YYYY_ YYYY_ YYYY_ YYYY_ YYYY_ YYYY_
MMMM_ MMMM_ MMMM_ MMMM_ CCCC_ YYYY_ YYYY_ YYYY( YYYY_ YYYY_ YYYY_ YYYY_ YYYY_ YYYY_ YYYY_ YYYY_ YYYY_ YYYY_ YYYY_ YYYY_ YYYY_ YYYY_ YYYY_ YYYY_ YYYY_ YYYY_ YYYY_ YYYY_ YYYY_ YYYY_ YYYY_ YYYY_ YYYY_ YYYY_ YYYY_
MMMM_ MMMM_ MMMM_ MCMC_ YYYY_ YYYY_ YYYY_ YYYY( YYYY_ YYYY_ MMMY_ MYYY_ MYYM_ YYYY_ YMMY_ YYYY_ MMYM_ MYYY_ MMYM_ MYYY_ YYYY_ YYYY_ YYYY_ YYYY_ YYYY_ YYYY_ YYYY_ YYYY_ YYYY_ YYYY_ YYYY_ YYYY_ YYYY_ YYYY_ YYYY_
MMMM_ MMMM_ CCCCD CCCC_ CCCC_ CCCC_ CCCC_ CYCY( YYYY_ YYYY_ MMMM_ MYMY_ YYYY_ YMMY_ YYYY_ YYYY_ YMYM_ YYYY_ YMYM_ YYYY_ YYYY_ YYYY_ YYYY_ YYYY_ YYYY_ YYYY_ YYYY_ YYYY_ YYYY_ YYYY_ YYYY_ YYYY_ YYYY_ YYYY_ YYYY_
MMMM_ MMMM_ MMMM_ MCMC_ YYYY_ YYYY_ YYYY_ YYYY( YYYY_ YYYY_ MYMY_ YYYY_ YMMY_ YYYY_ MYYM_ YYYY_ YMYM_ YYYY_ YMYM_ YYYY_ YYYY_ YYYY_ YYYY_ YYYY_ YYYY_ YYYY_ YYYY_ YYYY_ YYYY_ YYYY_ YYYY_ YYYY_ YYYY_ YYYY_ YYYY_
MMMMN MMMM_ MMMM_ MMMM_ CCCC_ YYYY_ YYYY_ YYYY( YYYY_ YYYY_ MMYY_ MYYY_ YYYY_ YYYY_ YYYY_ YYYY_ MMYY_ MYYY_ YMYY_ YYYY_ YYYY_ YYYY_ YYYY_ YYYY_ YYYY_ YYYY_ YYYY_ YYYY_ YYYY_ YYYY_ YYYY_ YYYY_ YYYY_ YYYY_ YYYY_
Explanation of gates.
Story line.