10 5 300.00 0
RRRR BBBB RYRY GGGG YYYY BBBB GRGR RRRR RRRR GGGG
RRRR BBBB RYRY GGBB YYYY BBBB RRRR RRRR RRRR RRRR
RRRR BBGG RRRR YYYY YYYY GGGG GGGG GGGG GGGG GGGG
BBBB YYYY BBBB GGGG BBBB YYYY BBBB BBBB BBBB BYBY
BBBB YYYY YYYY GGBB YYYY YYYY YYYY YYYY YYYY YYYY
CP00 LD90 L@71 C^03