6 6 10.00 0
RRRRP RRRR_ RRRR_ RRRR_ RRRR_ RRRR_
RRRR_ RRRR_ RRRR_ RRRR_ RRRR_ RRRR_
RRRR_ RRRR_ RRRR_ RRRR_ RRRR_ RRRR_
RRRR_ RRRR_ RRRR_ RRRR@ RRRR_ RRRR_
RRRR_ RRRR_ RRRR_ RRRR_ RRRR_ RRRR_
RRRR_ RRRR_ RRRR_ RRRR_ RRRR_ RRRRD
