10 5 300.00 0
YYYYD RRRR@ RRRR_ RRRR_ RRRR_ RRRRF RRRR_ RRRR_ YYYY_ YYYY_
GGGG_ BBBB_ BBBB_ RRRR_ BBBB_ BBBB_ BBBB_ BBBB_ BBBB_ GGGG_
GGGG_ GGGG_ GGGG_ RGRG_ GGGG_ GGGG_ GGGG_ GGGG_ BBBB_ GGGGP
GGGG_ BBBB^ BBBB_ BBBB_ BBBG_ BBBB_ RRRR_ BBBB_ BBBB_ GGGG_
YYYY_ RRRR_ RRRR_ RYRR_ YYRR_ YYYY_ RRRR_ RRRR_ YYYY_ YYYY_