10 5 300.00 0
YYYY RRRR RRRR RRRR RRRR RRRR RRRR RRRR YYYY YYYY
GGGG BBBB BBBB RRRR BBBB BBBB BBBB BBBB BBBB GGGG
GGGG GGGG GGGG RGRG GGGG GGGG GGGG GGGG BBBB GGGG
GGGG BBBB BBBB BBBB BBBG BBBB RRRR BBBB BBBB GGGG
YYYY RRRR RRRR RYRR YYRR YYYY RRRR RRRR YYYY YYYY
L,D,0,0 L,@,1,0 C,F,5,0 C,P,9,2 C,^,1,3