10 6 300.00 0
BBBB_ BBBB_ BBBB_ BBBB_ BBBB_ BBBB_ BBBB_ BBBB_ BBBB_ BBBB_
BBBB_ YYYYP BBBB_ BBBB_ BBBB_ BBBB_ BBBB_ BBBB_ BBBB_ BBBB_
BBBB_ YYYY_ BBBB_ BBBB_ YYYY{ BBBB_ YYYY} BBBB_ BBBB_ BBBB_
BBBB_ YYYY_ BBBB_ BBBB_ YYYY_ BBBB_ YYYY( BBBB_ BBBB_ BBBB_
BBBB_ YYYY_ YYYY_ YYYY_ YYYY_ YYYY( YYYY_ YYYY) YYYYD BBBB_
BBBB_ BBBB_ BBBB_ BBBB_ BBBB_ BBBB_ BBBB_ BBBB_ BBBB_ BBBB_
