10 10 300.00 0
RRRR_ RRRR_ RRRR_ RRRR_ RRRR_ RRRR_ RRRR_ RRRR_ RRRR_ RRRR_
RRRR_ RRRRP RRRR_ RRRR* RRRR_ RRRR_ RRRR_ RRRR_ RRRR* RRRR_
RRRR_ RRRR_ RRRR_ RRRR{ RRRR_ RRRR_ RRRR_ RRRR_ RRRR+ RRRR_
RRRR_ RRRR_ RRRR_ RRRR( RRRR_ RRRR_ RRRR_ RRRR_ RRRR+ RRRR_
RRRR_ RRRR_ RRRR_ RRRRG RRRR_ RRRR_ RRRR_ RRRR_ RRRR+ RRRR_
RRRR_ RRRR_ RRRR_ RRRR+ RRRR_ RRRR_ RRRR_ RRRR_ RRRR+ RRRR_
RRRR_ RRRR_ RRRR_ RRRRT RRRR_ RRRR_ RRRR_ RRRR_ RRRR+ RRRR_
RRRR_ RRRR_ RRRR_ RRRRY RRRR_ RRRR_ RRRR_ RRRR_ RRRR+ RRRR_
RRRR_ RRRR_ RRRR_ RRRR⌄ RRRR_ RRRR_ RRRR_ RRRR_ RRRRD RRRR_
RRRR_ RRRR_ RRRR_ RRRR_ RRRR_ RRRR_ RRRR_ RRRR_ RRRR_ RRRR_
