10 5 200.00 0
YYYY_ YYYY_ YYYY_ YYYY_ YYYY_ YYYY_ YYYY_ YYYY_ YYYY_ YYYY@
YYYY_ YYYY_ BBBBD YYYY_ YYYY_ YYYY_ YYYY_ BBBB_ YYYY_ YYYY_
YYYY_ YYYY_ BBYY_ YYYY_ YYYY_ YYYY_ YYYY_ BBYY_ YYYY_ YYYY_
YYYY_ YRYR_ YYYY_ YYYY_ YYYY_ YYYY_ YYYY_ YYYY_ RYRY_ YYYY_
YYYY_ YRYR_ RRRR_ RRRR_ RRRR_ RRRRP RRRR_ RRRR@ RYRY_ YYYYS
YYYY_ YRYR_ RRRR_ RRRR_ RRRR_ RRRR_ RRRR_ RRRR_ RYRY_ YYYY_