10 5 200.00 0
YYYY YYYY YYYY YYYY YYYY YYYY YYYY YYYY YYYY YYYY
YYYY YYYY BBBB YYYY YYYY YYYY YYYY BBBB YYYY YYYY
YYYY YYYY BBYY YYYY YYYY YYYY YYYY BBYY YYYY YYYY
YYYY YRYR YYYY YYYY YYYY YYYY YYYY YYYY RYRY YYYY
YYYY YRYR RRRR RRRR RRRR RRRR RRRR RRRR RYRY YYYY
LD21 L@71 CS94 CP54 L@90