7 7 300.00 0
RRRRP RRRR_ RRRR_ RRRR_ RRRR_ RRRR_ RRRRS
RRBB( RRRR_ RRRR_ RRRR_ RRRR_ RRRR_ RRGG_
BBBB_ GGGG_ GGGG_ GGGG_ GGGG_ GGGG_ GGGG+
BBBB_ GGGG{ GGGGG GGGG@ GGGG_ GGGG_ GGGGY
BBBB_ GGGG_ GGGG_ GGGG* GGGG_ GGGG_ GGGGT
BBBB_ BBBB_ BBBB_ BBBB_ BBBB_ BBBB_ BBBB_
BBBB_ BBBB_ BBBB_ BBBB_ BBBB_ BBBB_ BBBBD
