10 5 200.00 0
YYYYD YYYY_ YYYY_ YYYY_ YYYY_ YYYY_ YYYY) YYYY_ YYYY_ YYYY_
YYYY_ YYYY_ YYYY_ YYYY_ YYYY( YYYY_ YYYY) YYYY_ YYYY( YYYY_
YYYY_ YYYY_ YYYY_ YYYY_ YYYY( YYYY_ YYYY) YYYY_ YYYY( YYYY_
YYYY_ YYYY} YYYY_ YYYY_ YYYY( YYYY_ YYYY) YYYY_ YYYY( YYYY_
YYYYP YYYY{ YYYY_ YYYY_ YYYY( YYYY_ YYYY_ YYYY_ YYYY( YYYYS
