5 5 300.00 0
GGGG_ GGGG+ GGGG_ GGGG+ GGGGF
GGGG_ GGGG+ GGGGG GGGG+ GGGG_
GGGG_ GGGG_ GGGGG GGGG_ GGGG_
GGCC_ GGCC+ GGCCG GGCC+ GGCC_
CCCCP CCCC_ CCCC_ CCCC_ CCCCD
