35 17 60.00 0
YYYY_ YYYYG YYYY_ YYYYG YCCC_ CCCC_ CCCC_ CCCC_ CCCC_ CCCC_ CCCC_ CCCC_ CCCC_ CCCC_ CCCC_ CCCC_ CCCC_ CCCC_ CCCC_ CCCC_ CCCC_ CCCC_ CCCC_ CCCC_ CCCC_ CCCC_ CCCC_ CCCC_ CCCC_ CCCC_ CCCC_ CCCC_ CCCC_ CCCC_ CCCC_
YYYYG YYYY_ YYYYG YCCC_ CCCC_ CCCC_ CCCC_ CCCC_ CCCC_ CCCC_ CCCC_ CCCC_ CCCC_ CCCC_ CCCC_ CCCC_ CCCC_ CCCC_ CCCC_ CCCC_ CCCC_ CCCC_ CCCC_ CCCC_ CCCC_ CCCC_ CCCC_ CCCR_ RRRR_ CCRC_ CCCC_ CCCC_ CCCC_ CCCC_ CCCC_
YYYY_ YYYYG YCCC_ CCCC_ CCCC_ CCCC_ CCCC_ CCCC_ CCCC_ CCCC_ CCCC_ CCCC_ CCCC_ CCCC_ CCCC_ CCCC⌄ CCCC_ CCCC_ CCCC_ CCCC_ CCCC_ CCCC_ CCCC_ CCCC_ CCCC_ CCCC_ CCCC_ RRRR_ RRRR_ RRRR_ CCCC_ CCCC_ CCCC_ CCCC_ CCCC_
YYYYG YCCC_ CCCC_ CCCC_ CCCC_ CCCC_ CCCC_ CCCC_ CCCC_ CCCC_ CCCC_ CCCC_ CCCC_ CCCC_ CCCC_ CCCC_ CCCC_ CCCC_ CCCC_ CCCC_ CCCC_ CCCC_ CCCC_ CCCC_ CCCC_ CCCC_ CRCR_ RRRR_ RRRRD RRRR_ RCRC_ CCCC_ CCCC_ CCCC_ CCCC_
YCCC_ CCCC_ CCCC_ CCCC_ CCCC_ CCCC_ CCCC_ CCCC_ CCCC_ CCCC_ CCCC_ BBBB_ BBBB_ BBBB_ BBBB_ BBBB_ BBBB_ BBBB_ BBBB_ CCCC_ CCCC_ CCCC_ CCCC_ CCCC_ CCCC_ CCCC_ CRCR_ RRRR_ RRRR_ RRRR_ RCRC_ CCCC_ CCCC_ CCCC_ CCCC_
CCCC_ CCCC_ CCCC_ CCCC_ CCCC_ CCCC_ CCCC_ CCCC_ CCCC⌄ CCCC_ CCCC_ BBBB_ BBBB_ CCCC_ CCCC_ CCCC_ CCCC_ CCCC_ BBBB_ CCCC_ CCCC_ CCCC_ CCCC_ CCCC_ CCCC_ CCCC_ CRCR_ RRRR_ RRRR_ RRRR_ RCRC_ CCCC_ CCCC_ CCCC_ CCCC_
CCCC_ CCCC_ CCCC_ CCCC_ CCCC_ CCCC_ CCCC_ CCCC_ CCCC_ CCCC_ CCCC_ BBBB_ BBBB_ CCCC_ CCCC_ CCCCF CCCC_ CCCC_ BBBB_ CCCC_ CCCC_ CCCC_ CCCC_ CCCC_ CCCC_ CCCC_ CRCR_ RRRR_ RRRR_ RRRR_ RCRC_ CCCC_ CCCC_ CCCC_ CCCC_
CCCC_ CCCC_ CCCC_ CCCC_ CCCC_ CCCC_ CCCC_ CCCC_ CCCC_ CCCC_ CCCC_ BBBB_ BBBB_ CCCC_ CCCC_ CCCC_ CCCC_ CCCC_ BBBB_ BBBB_ BBBB_ BBBB_ BBBB_ BBBB_ BBBB_ BRBR) RRRR_ RRRR_ RRRR_ RRRR_ RRRR_ CCCC_ CCCC_ CCCC_ CCCC_
CCCC_ CCCC_ CCCC_ CCCC_ CCCC_ CCCC_ CCCC_ CCCC_ CCCC_ CCCC_ BBBB_ BBBB_ BBBB_ BBBB_ BBBB_ BBBB_ BBBB_ BBBB_ BBBB_ BBBB_ BBBB_ BBBB_ BBBBY BBBB_ BBBB_ BRBR) RRRR_ RRRR_ RRRR_ RRRR_ RRRR_ CCCC_ CCCC_ CCCC_ CCCC_
CCCC_ CCCC_ CCCC_ CCCC_ CCCC_ CCCC_ CCCC_ CCCC_ CCCC_ CCCC⌄ BBBB_ BBBB_ BBBB_ BBBB_ BBBB_ BBBB_ BBBB_ BBBB_ BBBB_ CCCC_ CCCC_ CCCC_ CCCC_ CCCC_ CCCC_ CCCC_ CRCR_ RRRR_ RRRR_ RRRR_ RCRC_ CCCC_ CCCC_ CCCC_ CCCC_
CCCC_ CCCC_ CCCC_ CCCC_ CCCC_ CCCC_ CCCC_ CCCC_ CCCC_ CCCC_ BBBB_ BBBB_ BBBB_ BBBB_ BBBB_ BBBBF BBBB_ BBBB_ BBBB_ CCCC_ CCCC_ CCCC_ CCCC_ CCCC_ CCCC_ CCCC_ CRCR_ RRRR_ RRRR_ RRRR_ RCRC_ CCCC_ CCCC_ CCCC_ CCCC_
CCCC_ CCCC_ CCCC_ CCCC_ CCCC_ CCCC_ CCCC_ CCCC_ CCCC_ CCCC_ BBBB_ BBBB_ BBBB_ BBBB_ BBBB_ BBBB_ BBBB_ BBBB_ BBBB_ CCCC_ CCCC_ CCCC_ CCCC_ CCCC_ CCCC_ CCCC_ CRRR_ RRRRG RRRR_ RRRRG RCRR_ CCCC_ CCCC_ CCCC_ CCCC_
CCCC_ CCCC_ CCCC_ CCCC_ CCCC_ CCCC_ CCCC_ CCCC_ CCCC_ CCCC_ CCCC_ BBBB_ BBBB_ BBBB_ BBBB_ BBBB_ BBBB_ BBBB_ BBBB_ CCCC_ CCCC_ CCCC_ CCCC_ CCCC_ CCCC_ CCCR_ RRRR_ RRRRG RRRR_ RRRRG RRRR_ CCRC_ CCCC_ CCCC_ CCCC_
CCCC_ CCCC_ CCCC_ CCCC_ CCCC_ CCCC_ CCCC_ CCCC_ CCCC_ CCCC_ CCCC_ BBBB_ BBBB_ BBBB_ BBBG_ BBGB_ BBBB_ BBBB_ BBBB_ CCCC_ CCCC⌄ CCCC_ CCCC_ CCCC_ CCCR_ RRRR_ RCCC_ CCCC_ CCCC_ CCCC_ CRCC_ RRRR_ CCRC_ CCCC_ CCCC_
CCCC_ CCCC_ CCCC_ CCCC_ CCCC_ CCCC_ CCCC_ CCCC_ CCCC_ CCCC_ CCCC_ BBBB@ BBBB@ BBBB_ GGGG_ GGGG_ BBBB_ BBBB_ BBBB_ CCCC_ CCCC_ CCCC_ CCCC_ CCCC_ CRCR_ RCRC_ CCCC_ CCCC_ CCCCT CCCC_ CCCC_ CRCR_ RCRC_ CCCC_ CCCC_
GGGG_ GGGGP GGGG_ GGGG_ GGGG_ GGGG_ GGGG_ GGGG_ GGGG+ GGGG_ GGGG_ GGGG_ GGGG* GGGG_ GGGG_ GGGG_ GGGG_ GGGG_ GGGG_ GGGG_ GGGG_ GGGG_ GGGG_ GGGG_ GGGG_ GGGG_ GGGG_ GGGG_ GGGG_ GGGG_ GGGG_ GGGG_ GGGG_ GGGG_ GGGG_
GGGG_ GGGG_ GGGG_ GGGG_ GGGG_ GGGG_ GGGG_ GGGG_ GGGG_ GGGG_ GGGG_ GGGG_ GGGG_ GGGG_ GGGG_ GGGG_ GGGG_ GGGG_ GGGG_ GGGG_ GGGG_ GGGG_ GGGG+ GGGG_ GGGG_ GGGG_ GGGG_ GGGG_ GGGG_ GGGG_ GGGG_ GGGG_ GGGG_ GGGG_ GGGG}
