35 22 60.00 0
BBBBD GGGG_ GGGG_ GGGG_ GGGG_ GGGG_ GGGG_ GGGG_ GGGG_ GGGG_ GGGG_ GGGG_ GGGG_ GGGG_ GGGG_ GGGG_ GGGG_ GGGG_ GGGG_ GGGG_ GGGG_ GGGG_ GGGG_ GGGG_ GGGG_ GGGG_ GGGG_ GGGG_ GGGG_ GGGG_ GGGG_ GGGG_ GGGG_ GGGG_ GGGG_
BBBB) GGGG_ GGGG_ GGGG* GGGG_ GGGG_ GGGG_ GGGG_ GGGG@ GGGG@ GGGG_ GGGG_ GGGG_ GGGG_ GGGG_ GGGG_ GGGG_ GGGG_ GGGG_ GGGG_ GGGG_ GGGG@ GGGG_ GGGG_ GGGG_ GGGG_ GGGG_ GGGG_ GGGG_ GGGG_ GGGG@ GGGG_ GGGG_ GGGG_ GGGG_
BBBB_ GGGG_ GGGG_ GGGG_ GGGG_ GGRR_ RRRR_ RRRR_ RRRR_ RRRR_ RRRR_ RRRR+ RRRR_ GGGG_ GGGG_ GGGG_ GGGG_ MMMM_ MMMM_ MMMM_ MMMM_ MMMM_ MMMM_ MMMMY MMMM_ GGGG_ YYYY_ YYYY_ YYYY_ YYYY_ YYYY_ YYYY_ YYYY_ YYYY_ GGGG_
BBBB_ GGGG_ GGGG_ GGGG_ GGGG_ RRRRF RRRR_ RRRR_ RRRR_ RRRR_ RRRR+ RRRR_ RRRR_ GGGG_ GGGG_ GGGG_ GGGG_ MMMM_ MMMM_ MMMMY MMMM_ MMMM_ MMMM_ MMMM_ MMMMY GGGG_ YYYY_ YYYY_ YYYYF YYYY_ YYYY_ YYYY_ YYYY_ YYYY_ GGGG⌄
BBBB_ GGGG_ GGGG_ GGGG_ GGGG_ RRRR_ RRRR_ RRRR_ RRRRP RRRR_ RRRR_ RRRR_ RRRR_ GGGG_ GGGG_ GGGG_ GGGG_ MMMM_ MMMM_ MMMM_ MMMM_ MMMM_ MMMM_ MMMM_ MMMM_ GGGG_ YYYY_ YYYY_ YYYY_ YYYY_ YYYY_ YYYY_ YYYY_ YYYY_ GGGG_
BBBB_ GGGG_ GGGG_ GGGG_ GGGG_ RRRR_ RRRR_ RRRR_ RRRR_ RRRR_ RRRR_ RRRR_ RRRR_ GGGG_ GGGG_ GGGG_ GGGG_ RMRM_ MMMM_ MMMM_ MMMM_ MMMM_ MMMM_ MMMM_ MMMM_ GGGG_ MYMY_ YYYY_ YYYY_ YYYY_ YYYY_ YYYY_ YYYY_ YYYY_ GGGG_
BBBB_ GGGG_ GGGG_ GGGG_ GGGG_ RRRR_ RRRR+ RRRR_ RRRR_ RRRR_ RRRR_ RRRR_ RRRR_ GGGG_ GGGG_ GGGG_ GGGG_ MMMM_ MMMM_ MMMM_ MMMM_ MMMM_ MMMM_ MMMM_ MMMM_ GGGG_ YYYY_ YYYYT YYYY_ YYYY_ YYYY_ YYYY_ YYYY_ YYYY_ GGGG_
BBBB_ GGGG_ GGGG_ GGGG_ GGGG_ RRRR_ RRRR_ RRRR_ RRRR_ RRRR_ RRRR+ RRRR+ RRRR_ GGGG_ GGGG_ GGGG_ GGGG_ MMMM_ MMMM_ MMMM_ MMMM_ MMMM_ MMMM_ MMMM_ MMMM_ GGGG_ YYYY_ YYYYT YYYY_ YYYY_ YYYY_ YYYY_ YYYY_ YYYY_ GGGG⌄
BBBB_ GGGG_ GGGG_ GGGG_ GGGG_ RRRR_ RRRR_ RRRR+ RRRR_ RRRR_ RRRR+ RRRR+ RRRR+ GGGG_ GGGG_ GGGG_ GGGG_ MMMMF MMMM_ MMMM_ MMMM_ MMMM_ MMMMY MMMM_ MMMM_ GGGG_ YYYYT YYYY_ YYYY_ YYYY_ YYYY_ YYYY_ YYYY_ YYYY_ GGGG_
BBBB_ GGGG_ GGGG_ GGGG_ GGGG_ GGGG_ GGGG_ GGGG_ GGGG_ GGGG_ GGGG_ GGGG_ GGGG_ GGGG_ GGGG_ GGGG_ GGGG_ GGGG_ GGGG_ GGGG_ GGGG_ GGGG_ GGGG_ GGGG_ GGGG_ GGGG_ GGGG_ GGGG_ GGGG_ GGGG_ GGGG_ GGGG_ GGGG_ GGGG_ GGGG_
BBBB_ GGGG_ GGGG_ GGGG_ GGGG_ GGGG_ GGGG_ GGGG_ GGGG_ GGGG_ GGGG_ GGGG_ GGGG_ GGGG_ GGGG_ GGGG_ GGGG_ GGGG_ GGGG_ GGGG_ GGGG_ GGGG_ GGGG_ GGGG_ GGGG_ GGGG_ CCCC_ CCCCG CCCC_ CCCC_ YYCC_ CCCC_ CCCC_ CCCCG GGGG_
BBBB_ GGGG_ GGGG_ GGGG_ GGGG_ GGGG_ GGGG_ GGGG_ GGGG_ GGGG@ GGGG_ GGGG_ GGGG_ GGGG_ GGGG_ GGGG_ GGGG_ GGGG_ GGGG_ GGGG_ GGGG_ GGGG_ GGGG_ GGGG_ GGGG_ GGGG_ CCCC_ CCCC_ CCCC_ CCCC_ CCCC_ CCCC_ CCCC_ CCCC_ GGGG_
BBBB_ GGGG_ GGGG_ GGGG_ GGGG_ GGGG_ GGGG_ GGGG_ GGGG_ GGGG_ GGGG_ GGGG_ GGGG_ GGGG_ GGGG_ GGGG_ GGGG_ GGGG_ GGGG_ GGGG_ GGGG_ GGGG_ GGGG_ GGGG_ GGGG_ GGGG_ CCCCG CCCC_ CCCC_ CCCC_ CCCC_ CCCC_ CCCC_ CCCC_ GGGG⌄
BBBB_ GGGG_ GGGG_ GGGG_ GGGG_ GGGG_ GGGG_ GGGG_ GGGG_ GGGG_ GGGG_ GGGG_ GGGG_ GGGG_ GGGG_ GGGG_ GGGG_ GGGGG GGGG_ GGGG_ GGGG_ GGGG_ GGGG_ GGGG_ GGGG_ GGGG_ CCCC_ CCCC_ CCCC_ CCCC_ CCCCG CCCC_ CCCC_ CCCC_ GGGG_
BBBB_ GGGG_ GGGG_ GGGG_ GGGG_ GGGG_ GGGG_ GGGG_ GGGG_ GGGG_ GGGG_ GGGG_ GGGG_ GGGG_ GGGG_ GGGG_ GGGG_ GGGG_ GGGG_ GGGG@ GGGG_ GGGG_ GGGG_ GGGG_ GGGG_ GGGG_ CCCC_ CCCC_ CCCC_ CCCC_ CCCC_ CCCCG CCCC_ CCCC_ GGGG_
BBBB_ GGGG_ GGGG_ GGGG_ GGGG_ GGGG_ GGGG_ GGGG_ GGGG_ GGGG_ GGGG_ GGGG_ GGGG_ GGGG_ GGGG_ GGGG_ GGGG_ GGGG_ GGGG_ GGGG@ GGGG_ GGGG_ GGGG_ GGGG_ GGGG_ GGGG_ CCCCF CCCC_ CCCC_ CCCC_ CCCC_ CCCC_ CCCC_ CCCCG GGGG_
BBBB_ GGGG_ GGGG_ GGGG_ GGGG_ GGGG_ GGGG_ GGGG_ GGGG_ GGGG_ GGGG_ GGGG_ GGGG_ GGGG_ GGGG_ GGGG_ GGGG_ GGGG_ GGGG_ GGGG_ GGGG_ GGGG_ GGGG_ GGGG_ GGGG_ GGGG_ CCCC_ CCCCG CCCC_ CCCC_ CCCC_ CCCC_ CCRR( CCCC_ GGGG⌄
BBBB_ GGGG_ GGGG_ GGGG{ GGGG_ GGGG_ GGGG_ GGGG_ GGGG_ GGGG_ GGGG_ GGGG_ GGGG_ GGGG_ GGGG_ GGGG_ GGGG_ GGGG_ GGGG_ GGGG+ GGGG_ GGGG_ GGGG_ GGGG_ GGGG_ GGGG_ GGGG_ GGGG_ GGGG_ GGGG_ RRRR_ RRRR_ RRRR_ RRRR_ GGGG_
BBBB_ GGGG_ GGGG_ GGGG_ GGGG_ GGGG_ GGGG_ GGGG_ GGGG_ GGGG_ GGGG_ GGGG_ GGGG_ GGGG_ GGGG_ GGGG_ GGGG_ GGGG_ GGGG_ GGGG_ GGGG_ GGGG_ GGGG_ GGGG_ GGGG_ GGGG_ GGGG_ GGGG_ GGGG_ GGGG_ RRRR_ RRRR_ RRRR_ RRRR_ GGGG_
BBBB_ GGGG_ GGGG_ GGGG* GGGG_ GGGG_ GGGG_ GGGG_ GGGG_ GGGG_ GGGG_ GGGG_ GGGG_ GGGG_ GGGG_ GGGG_ GGGG_ GGGG_ GGGG_ GGGG_ GGGG_ GGGG_ GGGG_ GGGG_ GGGG_ GGGG_ GGGG_ GGGG_ GGGG_ GGGG_ RRRR_ RRRR_ RRRR_ RRRR} GGGG⌄
BBBB_ GGGG_ GGGG_ GGGG_ GGGG_ GGGG_ GGGG_ GGGG_ GGGG_ GGGG_ GGGG_ GGGG_ GGGG_ GGGG_ GGGG_ GGGG_ GGGG_ GGGG_ GGGG_ GGGG_ GGGG_ GGGG_ GGGG_ GGGG_ GGGG_ GGGG_ GGGG_ GGGG_ GGGG_ GGGG_ GGGG_ GGGG_ GGGG_ GGGG_ GGGG_
BBBB_ BBBB_ BBBB_ BBBB_ BBBB_ BBBB_ BBBB_ BBBB_ BBBB_ BBBB_ BBBB_ BBBB_ BBBB_ BBBB_ BBBB_ BBBB_ BBBB_ BBBB_ BBBB_ BBBB_ BBBB_ BBBB_ BBBB_ BBBB_ BBBB_ BBBB_ BBBB_ BBBB_ BBBB_ BBBB_ BBBB_ BBBB_ BBBB_ BBBB_ GGBB_
